V	v
mol/L	mol/l
degrees Kelvin	k
grams/mole	g/mol
milligrams	mg
kg	kg
millimoles	mmol
K	k
Osmol/L	osmol/l
mole	mol
J/(g · K)	j/(g_·_k)
L	l
J	j
ppm	ppm
kcal/mol	kcal/mol
none	none
mol*dm^(–3)	mol/dm^3
L/(mol · s)	l/(mol_·_s)
mol/kg	mol/kg
KJ	kj
mg	mg
mmHg	mmhg
kilograms	kg
l	l
cm^3	cm^3
osmol/L	osmol/l
milliliters	ml
g/mol	g/mol
M	mol/l
°C	°c
calories	cal
mol	mol
kilojoules	kj
torr	torr
Pa	pa
grams	g
g	g
liters	l
milliequivalents	milliequivalents
cal	cal
atm	atm
g/(100 g H2O)	g
g/eq	g/eq
kJ	kj
g/L	g/l
J/(°C · g)	j/(°c_·_g)
ml	ml
mL	ml
grams per liter	g/l
J/(g * °C)	j/(°c_·_g)
pounds	pounds
J/(°C * g)	j/(°c_·_g)
dm^3	dm^3
moles	mol
kJ/mol	kj/mol
mol*L^(−1)	mol/l
mol/dm^3	mol/dm^3
N	n
ng	ng
kcal/g	kcal/g
°C/(kg * mol)	°c/(kg_·_mol)
celsius	°c
J/(mol * K)	j/(mol_·_k)
molar	mol/l
mol/g	mol/g
mg/ml	mg/ml
degree Celsius	°c
gm	g
milli grams	mg
Joules	j
Amperes	amperes
kcal	kcal
Pascals	pa
millliters	ml
mM	mm
J/(g * K)	j/(g_·_k)
J/mol	j/mol
m	m
eq/L	eq/l
u	amu
moles per liter	mol/l
kilojoules per minute	kj/min
molal	mol/g
degrees C	°c
J/g	j/g
ppm MgCO3	ppm
mEq/L	meq/l
J/(g * °C）	j/(g_·_°c）
MJ	mj
fluid ounces	fluid_ounces
mililiters	ml
nm	nm
mols	mol
per square inch	in^(-2)
square inch	in^2
J/(mol * °C)	j/(mol_·_°c)
s^(−1)	s^(-1)
g/100 mL	g/100_ml
mo/L	mol/l
particles per second	particles/s
psi	psi
amu	amu
litres	l
amperes	amperes
cubic meters	m^3
sec	s
ounces	oz
m^3	m^3
M/s	m/s
Celsius	°c
osmolar	osmol
kPa	kpa
dm^(-3)	dm^(-3)
atmospheres	atm
kilojoules per mole	kj/mol
years^(-1)	years^(-1)
mm Hg	mmhg
Kelvin	k
kilocalories	kcal
TON	t
parts per million	ppm
minutes	min
moles/L	mol/l
joules	j
atmosphere	atm
s^(-1)	s^(-1)
mmoles	mmol
mg/L	mg/l
millilieters	ml
millilitres	ml
hours	hour
tons	t
molarity	mol/l
degrees Celsius	°c
(M * min)^(-1)	(M_*_min)^(-1)
m/s	m/s
cm/s	cm/s
bar	bar
grams/100 mL	g/100_ml
J/(kg * K)	j/(kg_·_k)
kelvin	k
g/cm^3	g/cm^3
gallons	gallon
kJ/(kg * °C)	kj/(kg_·_°c)
cal/mol	cal/mol
MPa	mpa
tonnes	t
J/(g * degrees C)	j/(g_·_°c)
pounds per square inch	psi
g/mL	g/ml
μL	μl
cal/(g * °C)	cal/(g_·_°c)
atmospheric	atm
g/dm^3	g/dm^3
J/(kg * °C)	j/(kg_·_°c)
mol/(L * s)	mol/(l_·_s)
(M_*_min)^(-1)	(M_*_min)^(-1)
amperes	amperes
amu	amu
atm	atm
bar	bar
cal	cal
cal/(g_·_°c)	cal/(g_·_°c)
cal/mol	cal/mol
cm/s	cm/s
cm^3	cm^3
dm^(-3)	dm^(-3)
dm^3	dm^3
eq/l	eq/l
fluid_ounces	fluid_ounces
g	g
g/100_ml	g/100_ml
g/cm^3	g/cm^3
g/dm^3	g/dm^3
g/eq	g/eq
g/l	g/l
g/ml	g/ml
g/mol	g/mol
gallon	gallon
hour	hour
in^(-2)	in^(-2)
in^2	in^2
j	j
j/(g_·_k)	j/(g_·_k)
j/(g_·_°c)	j/(g_·_°c)
j/(g_·_°c）	j/(g_·_°c）
j/(kg_·_k)	j/(kg_·_k)
j/(kg_·_°c)	j/(kg_·_°c)
j/(mol_·_k)	j/(mol_·_k)
j/(mol_·_°c)	j/(mol_·_°c)
j/(°c_·_g)	j/(°c_·_g)
j/g	j/g
j/mol	j/mol
k	k
kcal	kcal
kcal/g	kcal/g
kcal/mol	kcal/mol
kg	kg
kj	kj
kj/(kg_·_°c)	kj/(kg_·_°c)
kj/min	kj/min
kj/mol	kj/mol
kpa	kpa
l	l
l/(mol_·_s)	l/(mol_·_s)
m	m
m/s	m/s
m^3	m^3
meq/l	meq/l
mg	mg
mg/l	mg/l
mg/ml	mg/ml
milliequivalents	milliequivalents
min	min
mj	mj
ml	ml
mm	mm
mmhg	mmhg
mmol	mmol
mol	mol
mol/(l_·_s)	mol/(l_·_s)
mol/dm^3	mol/dm^3
mol/g	mol/g
mol/kg	mol/kg
mol/l	mol/l
mpa	mpa
n	n
ng	ng
nm	nm
none	none
osmol	osmol
osmol/l	osmol/l
oz	oz
pa	pa
particles/s	particles/s
pounds	pounds
ppm	ppm
psi	psi
s	s
s^(-1)	s^(-1)
t	t
torr	torr
v	v
years^(-1)	years^(-1)
°c	°c
°c/(kg_·_mol)	°c/(kg_·_mol)
μl	μl
