(M * min)^(-1)	(M * min)^(-1)
J	j
J/(g * °C)	j/(°c · g)
J/(g · K)	j/(g · k)
J/(°C * g)	j/(°c · g)
J/(°C · g)	j/(°c · g)
K	k
KJ	kj
L	l
L/(mol · s)	l/(mol · s)
M	M
M	mol/l
M/s	M/s
MJ	Mj
N	n
None	none
Osmol/L	osmol/l
Pa	pa
V	v
amperes	amperes
atm	atm
atmospheres	atm
cal	cal
calories	cal
cm^3	cm^3
cubic meters	m^3
degrees Kelvin	k
dm^3	dm^3
g	g
g/(100 g H2O)	g
g/L	g/l
g/eq	g/eq
g/l	g/l
g/mol	g/mol
gm	g
grams	g
grams per liter	g/l
grams/mole	g/mol
j	j
j/(g_·_k)	j/(g_·_k)
j/(°c_·_g)	j/(°c_·_g)
joules	j
k	k
kJ	kj
kJ/mol	kj/mol
kPa	kpa
kcal	kcal
kcal/mol	kcal/mol
kg	kg
kilograms	kg
kilojoules	kj
kj	kj
kj/mol	kj/mol
l	l
l/(mol_·_s)	l/(mol_·_s)
liters	l
m	m
m/s	m/s
mJ	mj
mL	ml
m^3	m^3
mg	mg
milliequivalents	milliequivalents
milligrams	mg
milliliters	ml
millimoles	mmol
ml	ml
mmHg	mmhg
mmhg	mmhg
mmol	mmol
mmoles	mmol
mol	mol
mol*L^(−1)	mol/l
mol*dm^(–3)	mol/dm^3
mol/L	mol/l
mol/dm^3	mol/dm^3
mol/kg	mol/kg
mol/l	mol/l
molar	mol
mole	mol
moles	mol
moles/L	mol/l
n	n
none	none
osmol/l	osmol/l
ounces	oz
pa	pa
parts per million	ppm
pounds	pounds
ppm	ppm
sec	s
tonnes	t
torr	torr
v	v
years^(-1)	years^(-1)
°C	°c
°c	°c
μL	μl
